R 1920 1080
NO ./texture/east.xpm
SO ./texture/west.xpm
WE ./texture/south.xpm
EA ./texture/north.xpm
S ./path_to_the_sprite_texture
F 243, 243, 241
C 195,210,251

		1111111 1111 11111 11111
		1000000 0011 000001100001
		 1110001011110000020000001
		1001000000000000000000001
111111111011000001110000000000001
100000000011000001110111111111111
1111011111111101110000001001   
11110111111111011101010010001
11000000110101011100000010001
10002000000000001110000010001
10000000000000001101010010001
11000001110101011111011110N0111
11110111 1110101 101111010001
11111111 1111111 111111111111