R 1920 1080
NO ./texture/east.xpm
SO ./texture/west.xpm
WE ./texture/south.xpm
EA ./texture/north.xpm
S ./path_to_the_sprite_texture
F 243, 243, 241
C 195,210,  0

        1111111 1111 11111 11111
        100011    11 100001100001
        1111111111011110000020000111     
            1000000000000000000001
111111111111000001110000000000001
10000000001100000001011111111111
1111011111111101110000001001   
11110111111111011101010010001
11000000110101011100000010001
100020000000000011100000000001
10000000000000001101010000001
11000001110101011111011110N0111
11111    1110101 101111010101
11111111 1111111 111111111111